column_name	description
mel_geneID	D. melanogaster r6.17 FBgn
mel_geneSymbol	D. melanogaster r6.17 symbol
mel_chrom	D. melanogaster chromosome
mel_start	D. melanogaster gene start coordinate (0-based)
mel_end	D. melanogaster gene end coordinate
mel_strand	D. melanogaster gene strand
sim_geneID	D. simulans r2.02 FBgn
sim_geneSymbol	D. simulans r2.02 symbol
sim_chrom	D. simulans chromosome
sim_start	D. simulans gene start coordinate (0-based)
sim_end	D. simulans gene end coordinate
sim_strand	D. simulans gene strand
orthoDB_groupID	OrthoDB groupID
num_frags_ttest	"In D. melanogaster, number of exon fragments tested for DE with t-test"
manual_model_check	"In D. melanogaster, for sum of the flag_manual_model_check (flag_manual_model_check = 1 if levine pval <= 0.05 OR resid pval <= 0.05) for all exon fragments of the gene"
sum_frags_le05	"In D. melanogaster, number of exon fragments in the gene with t-test p-value <= 0.5"
ttest_minpval	"In D. melanogaster, minimum t-test p-value across exon fragments in the gene"
num_frags_ttest_0_ratio2_F	"In D. melanogaster,  sum of the flag_ttest_0_ratio2_F flags by gene.  Flag_ttest_0_ratio2_F = 1 if flag_ttest_pval = 0 and ratio_expressed = fem"
num_frags_ttest_0_ratio2_M	"In D. melanogaster, sum of the flag_ttest_0_ratio2_M flags by gene.  Flag_ttest_0_ratio2_M = 1 if flag_ttest_pval = 0 and ratio_expressed = male"
num_frags_ttest_0_ratio2_U	"In D. melanogaster, sum of the flag_ttest_0_ratio2_U flags by gene.  Flag_ttest_0_ratio2_U = 1 if flag_ttest_pval = 0 and ratio_expressed = unb"
num_frags_ttest_0_trend_F	"In D. melanogaster,  sum of the flag_ttest_0_trend_F flags by gene.  Flag_ttest_0_trend_F = 1 if flag_ttest_pval = 0 and ratio_trend = fem"
num_frags_ttest_0_trend_M	"In D. melanogaster, sum of the flag_ttest_0_trend_M flags by gene.  Flag_ttest_0_trend_M = 1 if flag_ttest_pval = 0 and ratio_trend = male"
num_frags_ttest_0_trend_U	"In D. melanogaster, sum of the flag_ttest_0_trend_U flags by gene.  Flag_ttest_0_trend_U = 1 if flag_ttest_pval = 0 and ratio_trend = unb"
num_frags_ttest_1_ratio2_F	"In D. melanogaster,  sum of the flag_ttest_1_ratio2_F flags by gene.  Flag_ttest_1_ratio2_F = 1 if flag_ttest_pval = 1 and ratio_expressed = fem"
num_frags_ttest_1_ratio2_M	"In D. melanogaster, sum of the flag_ttest_1_ratio2_M flags by gene.  Flag_ttest_1_ratio2_M = 1 if flag_ttest_pval = 1 and ratio_expressed = male"
num_frags_ttest_1_ratio2_U	"In D. melanogaster, sum of the flag_ttest_1_ratio2_U flags by gene.  Flag_ttest_1_ratio2_U = 1 if flag_ttest_pval = 1 and ratio_expressed = unb"
num_frags_ttest_1_trend_F	"In D. melanogaster,  sum of the flag_ttest_1_trend_F flags by gene.  Flag_ttest_1_trend_F = 1 if flag_ttest_pval = 1 and ratio_trend = fem"
num_frags_ttest_1_trend_M	"In D. melanogaster, sum of the flag_ttest_1_trend_M flags by gene.  Flag_ttest_1_trend_M = 1 if flag_ttest_pval = 1 and ratio_trend = male"
num_frags_ttest_1_trend_U	"In D. melanogaster, sum of the flag_ttest_1_trend_U flags by gene.  Flag_ttest_1_trend_U = 1 if flag_ttest_pval = 1 and ratio_trend = unb"
num_k4_none	Number of D. melanogaster exon fragments with no H3K4me3 detected in either sex
num_k4_both	Number of D. melanogaster exon fragments with H3K4me3 detected in both sexes
num_k4_fem	Number of D. melanogaster exon fragments with H3K4me3 detected in females
num_k4_male	Number of D. melanogaster exon fragments with H3K4me3 detected in males
sum_fragments_k4	Number of D. melanogaster exon fragments with H3K4me3 detected
gene_k4	"In D. melanogaster, the gene classification for H3K4me3 exon fragment presence: _'none' if sum_fragments_k4==0, 'male_and_female_and_both' if num_k4_both>0 & num_k4_fem>0 & num_k4_male>0, 'male_and_female"" if num_k4_both==0 & num_k4_fem>0 & num_k4_male>0, 'male_and_unb' if num_k4_both>0 & num_k4_fem==0 & num_k4_male>0, 'fem_and_unb' if num_k4_both>0 & num_k4_fem>0 & num_k4_male==0, 'unb' if num_k4_both>0 & num_k4_fem==0 & num_k4_male==0, 'male' if num_k4_both==0 & num_k4_fem==0 & num_k4_male>0, and 'fem' if num_k4_both==0 & num_k4_fem>0 & num_k4_male==0"
num_k27_none	Number of D. melanogaster exon fragments with no H3K27me2me3 detected in either sex
num_k27_both	Number of D. melanogaster exon fragments with H3K27me2me3 detected in both sexes
num_k27_fem	Number of D. melanogaster exon fragments with H3K27me2me3 detected in females
num_k27_male	Number of D. melanogaster exon fragments with H3K27me2me3 detected in males
sum_fragments_k27	Number of D. melanogaster exon fragments with H3K27me2me3 detected
gene_k27	"In D. melanogaster, the gene classification for H3K27me2me3 exon fragment presence: _'none' if sum_fragments_k27==0, 'male_and_female_and_both' if num_k27_both>0 & num_k27_fem>0 & num_k27_male>0, 'male_and_female"" if num_k27_both==0 & num_k27_fem>0 & num_k27_male>0, 'male_and_unb' if num_k27_both>0 & num_k27_fem==0 & num_k27_male>0, 'fem_and_unb' if num_k27_both>0 & num_k27_fem>0 & num_k27_male==0, 'unb' if num_k27_both>0 & num_k27_fem==0 & num_k27_male==0, 'male' if num_k27_both==0 & num_k27_fem==0 & num_k27_male>0, and 'fem' if num_k27_both==0 & num_k27_fem>0 & num_k27_male==0"
num_rna_both	Number of D. melanogaster exon fragments with expression detected in both sexes
num_rna_none	Number of D. melanogaster exon fragments with no expression detected in either sex
num_rna_male	Number of D. melanogaster exon fragments with expression detected in males
num_rna_fem	Number of D. melanogaster exon fragments with expression detected in females
sum_fragments_rna_detected	Number of D. melanogaster exon fragments with expression detected in either sex
gene_rna	"In D. melanogaster, the gene classification for exon fragment expression detection: _'none' if sum_fragments_rna_detected==0, 'male_and_female_and_both' if num_rna_both>0 & num_rna_fem>0 & num_rna_male>0, 'male_and_female"" if num_rna_both==0 & num_rna_fem>0 & num_rna_male>0, 'male_and_both' if num_rna_both>0 & num_rna_fem==0 & num_rna_male>0, 'fem_and_both' if num_rna_both>0 & num_rna_fem>0 & num_rna_male==0, 'both' if num_rna_both>0 & num_rna_fem==0 & num_rna_male==0, 'male' if num_rna_both==0 & num_rna_fem==0 & num_rna_male>0, and 'fem' if num_rna_both==0 & num_rna_fem>0 & num_rna_male==0"
num_frag_detected05	Number of D. melanogaster exon fragments with expression detected in either sex with an APN>5
num_frag_not_detected05	Number of D. melanogaster exon fragments with expression detected in either sex with an APN<5
flag_rna_detected05	1 if num_frag_detected05 > 0
biological_process	Biological process GOids associated with the D. melanogaster gene (separated by '|')
goterm_biol_process	Biological process GO terms associated with the D. melanogaster gene (separated by '|')
molecular_function	Molecular function GOids associated with the D. melanogaster gene (separated by '|')
goterm_mol_function	Molecular function GO terms associated with the D. melanogaster gene (separated by '|')
cellular_component	Cellular component GOids associated with the D. melanogaster gene (separated by '|')
goterm_cell_component	Cellular component GO terms associated with the D. melanogaster gene (separated by '|')
num_transcripts	Number of transcripts in the D. melanogaster r6.17 reference annotation
flag_single_transcript	1 if gene has a single transcript in the D. melanogaster r6.17 reference annotation
xsome	Chromosomal location of D. melanogaster gene: X for X chromsome and A for autosomes (excluding chromosome 4)
flag_4Y	1 if D. melanogaster gene is on chromosome 4 or the Y chromosome
flag_X	1 if D. melanogaster gene is on the X chromosome
flag_Y	1 if D. melanogaster gene is on the Y chromosome
sim_num_frags_ttest	"In D. simulans, number of exon fragments tested for DE with t-test"
sim_manual_model_check	"In D. simulans, for sum of the flag_manual_model_check (flag_manual_model_check = 1 if levine pval <= 0.05 OR resid pval <= 0.05) for all exon fragments of the gene"
sim_sum_frags_le05	"In D. simulans, number of exon fragments in the gene with t-test p-value <= 0.5"
sim_ttest_minpval	"In D. simulans, minimum t-test p-value across exon fragments in the gene"
sim_num_frags_ttest_0_ratio2_F	"In D. simulans,  sum of the flag_ttest_0_ratio2_F flags by gene.  Flag_ttest_0_ratio2_F = 1 if flag_ttest_pval = 0 and ratio_expressed = fem"
sim_num_frags_ttest_0_ratio2_M	"In D. simulans, sum of the flag_ttest_0_ratio2_M flags by gene.  Flag_ttest_0_ratio2_M = 1 if flag_ttest_pval = 0 and ratio_expressed = male"
sim_num_frags_ttest_0_ratio2_U	"In D. simulans, sum of the flag_ttest_0_ratio2_U flags by gene.  Flag_ttest_0_ratio2_U = 1 if flag_ttest_pval = 0 and ratio_expressed = unb"
sim_num_frags_ttest_0_trend_F	"In D. simulans,  sum of the flag_ttest_0_trend_F flags by gene.  Flag_ttest_0_trend_F = 1 if flag_ttest_pval = 0 and ratio_trend = fem"
sim_num_frags_ttest_0_trend_M	"In D. simulans, sum of the flag_ttest_0_trend_M flags by gene.  Flag_ttest_0_trend_M = 1 if flag_ttest_pval = 0 and ratio_trend = male"
sim_num_frags_ttest_0_trend_U	"In D. simulans, sum of the flag_ttest_0_trend_U flags by gene.  Flag_ttest_0_trend_U = 1 if flag_ttest_pval = 0 and ratio_trend = unb"
sim_num_frags_ttest_1_ratio2_F	"In D. simulans,  sum of the flag_ttest_1_ratio2_F flags by gene.  Flag_ttest_1_ratio2_F = 1 if flag_ttest_pval = 1 and ratio_expressed = fem"
sim_num_frags_ttest_1_ratio2_M	"In D. simulans, sum of the flag_ttest_1_ratio2_M flags by gene.  Flag_ttest_1_ratio2_M = 1 if flag_ttest_pval = 1 and ratio_expressed = male"
sim_num_frags_ttest_1_ratio2_U	"In D. simulans, sum of the flag_ttest_1_ratio2_U flags by gene.  Flag_ttest_1_ratio2_U = 1 if flag_ttest_pval = 1 and ratio_expressed = unb"
sim_num_frags_ttest_1_trend_F	"In D. simulans,  sum of the flag_ttest_1_trend_F flags by gene.  Flag_ttest_1_trend_F = 1 if flag_ttest_pval = 1 and ratio_trend = fem"
sim_num_frags_ttest_1_trend_M	"In D. simulans, sum of the flag_ttest_1_trend_M flags by gene.  Flag_ttest_1_trend_M = 1 if flag_ttest_pval = 1 and ratio_trend = male"
sim_num_frags_ttest_1_trend_U	"In D. simulans, sum of the flag_ttest_1_trend_U flags by gene.  Flag_ttest_1_trend_U = 1 if flag_ttest_pval = 1 and ratio_trend = unb"
sim_num_k4_none	Number of D. simulans exon fragments with no H3K4me3 detected in either sex
sim_num_k4_fem	Number of D. simulans exon fragments with H3K4me3 detected in both sexes
sim_num_k4_male	Number of D. simulans exon fragments with H3K4me3 detected in females
sim_num_k4_both	Number of D. simulans exon fragments with H3K4me3 detected in males
sim_sum_fragments_k4	Number of D. simulans exon fragments with H3K4me3 detected
sim_gene_k4	"In D. simulans, the gene classification for H3K4me3 exon fragment presence: _'none' if sim_sum_fragments_k4==0, 'male_and_female_and_both' if sim_num_k4_both>0 & sim_num_k4_fem>0 & sim_num_k4_male>0, 'male_and_female"" if sim_num_k4_both==0 & sim_num_k4_fem>0 & sim_num_k4_male>0, 'male_and_unb' if sim_num_k4_both>0 & sim_num_k4_fem==0 & sim_num_k4_male>0, 'fem_and_unb' if sim_num_k4_both>0 & sim_num_k4_fem>0 & sim_num_k4_male==0, 'unb' if sim_num_k4_both>0 & sim_num_k4_fem==0 & sim_num_k4_male==0, 'male' if sim_num_k4_both==0 & num_k4_fem==0 & sim_num_k4_male>0, and 'fem' if sim_num_k4_both==0 & sim_num_k4_fem>0 & sim_num_k4_male==0"
sim_num_k27_fem	Number of D. simulans exon fragments with no H3K27me2me3 detected in either sex
sim_num_k27_none	Number of D. simulans exon fragments with H3K27me2me3 detected in both sexes
sim_num_k27_male	Number of D. simulans exon fragments with H3K27me2me3 detected in females
sim_num_k27_both	Number of D. simulans exon fragments with H3K27me2me3 detected in males
sim_sum_fragments_k27	Number of D. simulans exon fragments with H3K27me2me3 detected
sim_gene_k27	"In D. simulans, the gene classification for H3K27me2me3 exon fragment presence: _'none' if sim_sum_fragments_k27==0, 'male_and_female_and_both' if sim_num_k27_both>0 & sim_num_k27_fem>0 & sim_num_k27_male>0, 'male_and_female"" if sim_num_k27_both==0 & sim_num_k27_fem>0 & sim_num_k27_male>0, 'male_and_unb' if sim_num_k27_both>0 & sim_num_k27_fem==0 & sim_num_k27_male>0, 'fem_and_unb' if sim_num_k27_both>0 & sim_num_k27_fem>0 & sim_num_k27_male==0, 'unb' if sim_num_k27_both>0 & sim_num_k27_fem==0 & sim_num_k27_male==0, 'male' if sim_num_k27_both==0 & sim_num_k27_fem==0 & sim_num_k27_male>0, and 'fem' if sim_num_k27_both==0 & sim_num_k27_fem>0 & sim_num_k27_male==0"
sim_num_rna_none	Number of D. simulans exon fragments with expression detected in both sexes
sim_num_rna_both	Number of D. simulans exon fragments with no expression detected in either sex
sim_num_rna_fem	Number of D. simulans exon fragments with expression detected in males
sim_num_rna_male	Number of D. simulans exon fragments with expression detected in females
sim_sum_fragments_rna_detected	Number of D. simulans exon fragments with expression detected in either sex
sim_gene_rna	"In D. simulans, the gene classification for exon fragment expression detection: _'none' if sim_sum_fragments_rna_detected==0, 'male_and_female_and_both' if sim_num_rna_both>0 & sim_num_rna_fem>0 & sim_num_rna_male>0, 'male_and_female"" if sim_num_rna_both==0 & sim_num_rna_fem>0 & sim_num_rna_male>0, 'male_and_both' if sim_num_rna_both>0 & sim_num_rna_fem==0 & sim_num_rna_male>0, 'fem_and_both' if sim_num_rna_both>0 & sim_num_rna_fem>0 & sim_num_rna_male==0, 'both' if sim_num_rna_both>0 & sim_num_rna_fem==0 & sim_num_rna_male==0, 'male' if sim_num_rna_both==0 & sim_num_rna_fem==0 & sim_num_rna_male>0, and 'fem' if sim_num_rna_both==0 & sim_num_rna_fem>0 & sim_num_rna_male==0"
sim_num_frag_not_detected05	Number of D. simulans exon fragments with expression detected in either sex with an APN>5
sim_num_frag_detected05	Number of D. simulans exon fragments with expression detected in either sex with an APN<5
sim_flag_rna_detected05	1 if sim_num_frag_detected05 > 0
sim_num_transcripts	Number of transcripts in the D. simulans r2.02 reference annotation
sim_flag_single_transcript	1 if gene has a single transcript in the D. simulans r2.02 reference annotation
sim_xsome	Chromosomal location of D. simulans gene: X for X chromsome and A for autosomes (excluding chromosome 4)
sim_flag_4Y	1 if D. simulans gene is on chromosome 4 or the Y chromosome
sim_flag_X	1 if D. simulans gene is on the X chromosome
sim_flag_Y	1 if D. simulans gene is on the Y chromosome
gene_ratio2_ttest	"In D. melanogaster, the gene classification for significant DE with 2 fold change: 'male_and_female' if num_frags_ttest_1_ratio2_M>0 & num_frags_ttest_1_ratio2_F>0, 'male' if num_frags_ttest_1_ratio2_M>0 & num_frags_ttest_1_ratio2_F==0, 'female' if num_frags_ttest_1_ratio2_M==0 & num_frags_ttest_1_ratio2_F>0, 'ttestLowFC' if num_frags_ttest_1_ratio2_M==0 & num_frags_ttest_1_ratio2_F==0 & num_frags_ttest_1_ratio2_U>0, or 'unbiased' if num_frags_ttest_1_ratio2_M==0 & num_frags_ttest_1_ratio2_F==0 & num_frags_ttest_1_ratio2_U==0 & (num_frags_ttest_0_ratio2_M+num_frags_ttest_0_ratio2_F+num_frags_ttest_0_ratio2_U)>0"
gene_trend_ttest	"In D. melanogaster, the gene classification for significant DE: 'male_and_female' if num_frags_ttest_1_trend_M>0 & num_frags_ttest_1_trend_F>0, 'male' if num_frags_ttest_1_trend_M>0 & num_frags_ttest_1_trend_F==0, 'female' if num_frags_ttest_1_trend_M==0 & num_frags_ttest_1_trend_F>0, 'ttestLowFC' if num_frags_ttest_1_trend_M==0 & num_frags_ttest_1_trend_F==0 & num_frags_ttest_1_trend_U>0, or 'unbiased' if num_frags_ttest_1_trend_M==0 & num_frags_ttest_1_trend_F==0 & num_frags_ttest_1_trend_U==0 & (num_frags_ttest_0_trend_M+num_frags_ttest_0_trend_F+num_frags_ttest_0_trend_U)>0"
sim_gene_ratio2_ttest	"In D. simulans, the gene classification for significant DE with 2 fold change: 'male_and_female' if sim_num_frags_ttest_1_ratio2_M>0 & sim_num_frags_ttest_1_ratio2_F>0, 'male' if sim_num_frags_ttest_1_ratio2_M>0 & sim_num_frags_ttest_1_ratio2_F==0, 'female' if sim_num_frags_ttest_1_ratio2_M==0 & sim_num_frags_ttest_1_ratio2_F>0, 'ttestLowFC' if sim_num_frags_ttest_1_ratio2_M==0 & sim_num_frags_ttest_1_ratio2_F==0 & sim_num_frags_ttest_1_ratio2_U>0, or 'unbiased' if sim_num_frags_ttest_1_ratio2_M==0 & sim_num_frags_ttest_1_ratio2_F==0 & sim_num_frags_ttest_1_ratio2_U==0 & (sim_num_frags_ttest_0_ratio2_M+sim_num_frags_ttest_0_ratio2_F+sim_num_frags_ttest_0_ratio2_U)>0"
sim_gene_trend_ttest	"In D. simulans, the gene classification for significant DE: 'male_and_female' if sim_num_frags_ttest_1_trend_M>0 & sim_num_frags_ttest_1_trend_F>0, 'male' if sim_num_frags_ttest_1_trend_M>0 & sim_num_frags_ttest_1_trend_F==0, 'female' if sim_num_frags_ttest_1_trend_M==0 & sim_num_frags_ttest_1_trend_F>0, 'ttestLowFC' if sim_num_frags_ttest_1_trend_M==0 & sim_num_frags_ttest_1_trend_F==0 & sim_num_frags_ttest_1_trend_U>0, or 'unbiased' if sim_num_frags_ttest_1_trend_M==0 & sim_num_frags_ttest_1_trend_F==0 & sim_num_frags_ttest_1_trend_U==0 & (sim_num_frags_ttest_0_trend_M+sim_num_frags_ttest_0_trend_F+sim_num_frags_ttest_0_trend_U)>0"
flag_Newell2016_f_bias_input	"1 if gene is female-biased in D. melanogaster head for the Input of TRAP in Newell, et al. 2016"
flag_goldman2007_ds_tra_not_ds_dsx_fru	"1 if gene determined to be regulated by TRA, but not downstream of DSX or FRU-M in Goldman and Arbeitman 2007"
flag_dsxNullF_induced	"1 if gene is upregulated in dsx null females compared to control females (repressed by DSX-F) in Arbeitman, et al. 2016"
flag_dsxNullF_repressed	"1 if gene is downregulated in dsx null females compared to control females (induced by DSX-F) in Arbeitman, et al. 2016"
flag_dsxD_repressed	"1 if gene is downregulated in dsx mutant pseudomales compared to control females (repressed by DSX-M or induced by DSX-F) in Arbeitman, et al. 2016"
flag_Chang2011_f_biased	"1 if gene is female-biased in D. melanogaster head in Chang, et al. 2011 "
flag_Chang2011_m_biased	"1 if gene is male-biased in D. melanogaster head in Chang, et al. 2011 "
flag_Chang2011_sex_biased	"1 if gene is sex-biased in D. melanogaster head in Chang, et al. 2011 "
flag_Chang2011_ds_tra	"1 if gene is determined to be downstream of TRA in Chang, et al. 2011"
flag_Newell2016_mixed_bias_input	"1 if gene has male and female sex-biased exons in the head for the input of TRAP in Newell, et al. 2016"
flag_Fear2015_genes_added_to_sexdet	"1 if gene added to the sex determination pathway using structural equation modeling of females in Fear, et al. 2015"
flag_Newell2016_f_bias_TRAP	"1 if gene is female-biased in the fru-P1 expressing neurons of TRAP in Newell, et al. 2016"
flag_Newell2016_m_bias_input	"1 if gene is male-biased in D. melanogaster head for the input of TRAP in Newell, et al. 2016"
flag_sex_det_pathway	1 if gene is in the sex determination pathway
flag_mcintyre2006_sex_bias	"1 if gene has sex-biased splicing in D. melanogaster whole body in McIntyre, et al. 2006"
flag_luo2011_dsx_bs	"1 if gene has a dsx binding site in D. melanogaster whole body in Luo, et al. 2011"
flag_Newell2016_mixed_bias_TRAP	"1 if gene has male and female sex-biased exons in the fru-P1 expressng neurons of TRAP in Newell, et al. 2016"
flag_Newell2016_m_bias_TRAP	"1 if gene is male-biased in the fru-P1 expressing neurons of TRAP in Newell, et al. 2016"
flag_chang2011_tra_bs	"1 if gene has a tra binding site in Chang, et al. 2011"
flag_fruMC_overexp_male_repressed	"1 if gene is downregulated in males with FRU-MC isoform overexpressed in Dalton, et al. 2013"
flag_fruMC_overexp_female_repressed	"1 if gene is downregulated in females with FRU-MC isoform ectopically expressed in Dalton, et al. 2013"
flag_fruMC_overexp_male_induced	"1 if gene is upregulated in males with FRU-MC isoform overexpressed in Dalton, et al. 2013"
flag_fruMC_overexp_female_induced	"1 if gene is upregulated in females with FRU-MC isoform ectopically expressed in Dalton, et al. 2013"
flag_fruMA_overexp_male_repressed	"1 if gene is downregulated in males with FRU-MA isoform overexpressed in Dalton, et al. 2013"
flag_fruMA_overexp_female_repressed	"1 if gene is downregulated in females with FRU-MA isoform ectopically expressed in Dalton, et al. 2013"
flag_fruMA_overexp_male_induced	"1 if gene is upregulated in males with FRU-MA isoform overexpressed in Dalton, et al. 2013"
flag_fruMA_overexp_female_induced	"1 if gene is upregulated in females with FRU-MA isoform ectopically expressed in Dalton, et al. 2013"
flag_genes_with_fruM_bs	"1 if gene has fruM binding site in Dalton, et al. 2013"
flag_fruMB_overexp_male_repressed	"1 if gene is downregulated in males with FRU-MB isoform overexpressed in Dalton, et al. 2013"
flag_fruMB_overexp_female_repressed	"1 if gene is downregulated in females with FRU-MB isoform ectopically expressed in Dalton, et al. 2013"
flag_fruMB_overexp_male_induced	"1 if gene is upregulated in males with FRU-MB isoform overexpressed in Dalton, et al. 2013"
flag_fruMB_overexp_female_induced	"1 if gene is upregulated in females with FRU-MB isoform ectopically expressed in Dalton, et al. 2013"
flag_fruM_overexp_female_repressed	"1 if gene is downregulated in females with FRU-MA, FRU-MB, or FRU-MC isoforms ectopically expressed in Dalton, et al. 2013"
flag_fruM_overexp_male_induced	"1 if gene is upregulated in males with FRU-MA, FRU-MB, or FRU-MC isoform overexpressed in Dalton, et al. 2013"
flag_fruM_overexp_female_induced	"1 if gene is upregulated in females with FRU-MA, FRU-MB, or FRU-MC isoforms ectopically expressed in Dalton, et al. 2013"
flag_goldman2007_sex_bias	1 if gene is sex-biased in head tissue in Goldman and Arbeitman 2007
flag_goldman2007_ds_tra	1 if gene is determined to be downstream of TRA in Goldman and Arbeitman 2007
flag_dsxD_induced	"1 if gene is upregulated in dsx mutant pseudomales compared to control females (repressed by DSX-M or induced by DSX-F) in Arbeitman, et al. 2016"
flag_dsx_ctrl_m_bias	"1 if gene is male-biased in WT control D. melanogaster in Arbeitman, et al. 2016"
flag_dsx_ctrl_f_bias	"1 if gene is female-biased in WT control D. melanogaster in Arbeitman, et al. 2016"
flag_fruM_overexp_male_repressed	"1 if gene is downregulated in males with FRU-MA, FRU-MB, or FRU-MC isoform overexpressed in Dalton, et al. 2013"
flag_redfly_TF	1 if gene is annotated as a transcription factor in RedFly database as of 11/1/2020
flag_redfly_TF_target	1 if gene is annotated as a transcription factor target in RedFly database as of 11/1/2020
flag_graze2012_AI_hybrid_all_sim_bias	"1 if all exons of the gene found to be biased towards the D. simulans allele in D. melanogaster-D. simulans hybrids in Graze, et al. 2012"
flag_graze2012_AI_hybrid_partial_mel_bias	"1 if at least one (but not all) exon of the gene found to be biased towards the D. melanogaster allele in D. melanogaster-D. simulans hybrids in Graze, et al. 2012"
flag_graze2012_AI_hybrid_partial_sim_bias	"1 if at least one (but not all) exon of the gene found to be biased towards the D. simulans allele in D. melanogaster-D. simulans hybrids in Graze, et al. 2012"
flag_graze2012_AI_hybrid_any_mel_bias	"1 if at least one exon of the gene found to be biased towards the D. melanogaster allele in D. melanogaster-D. simulans hybrids in Graze, et al. 2012"
flag_palmateer2021_10-12dayMaleFruP1Consensus_H3K4me3	"1 if H3K4me3 detected in gene in 10-12 day old male fru-P1 expressing neurons (using consensus peak method) in Palmateer, et al. 2021"
flag_graze2012_AI_hybrid_all_mel_bias	"1 if all exons of the gene found to be biased towards the D. melanogaster allele in D. melanogaster-D. simulans hybrids in Graze, et al. 2012"
flag_graze2012_AI_hybrid_any_sim_bias	"1 if at least one exon of the gene found to be biased towards the D. simulans allele in D. melanogaster-D. simulans hybrids in Graze, et al. 2012"
flag_mel_MK_sig_0.05	"1 if gene has evidence of adaptive evolution (MK test p-value < 0.05) in Langely, et al. 2012 and Zhao and Begun 2017"
flag_mel_MK_sig_DoS_alpha_gt_0	"1 if gene has evidence of adaptive evolution and positive selection (MK test p-value < 0.05 and positive DoS) in Langely, et al. 2012 and Zhao and Begun 2017"
flag_mel_sim_hyd_moj_MK_sig_DoS_alpha_gt_0	"1 if gene has evidence of adaptive evolution and positive selection (MK test p-value < 0.05 and positive DoS) that is conserved in the mel-sim clade and hyd-moj clade in Langely, et al. 2012 and Zhao and Begun 2017"
flag_palmateer2021_10-12dayMaleFruP1Consensus_H3K27me3	"1 if H3K27me3 detected in gene in 10-12 day old male fru-P1 expressing neurons (using consensus peak method) in Palmateer, et al. 2021"
flag_palmateer2021_1-dayMaleElavConsensus_H3K4me3	"1 if H3K4me3 detected in gene in 1 day old male elav-expressing neurons (using consensus peak method) in Palmateer, et al. 2021"
flag_palmateer2021_1-dayMaleElavConsensus_H3K27me3	"1 if H3K27me3 detected in gene in 1 day old male elav-expressing neurons (using consensus peak method) in Palmateer, et al. 2021"
flag_palmateer2021_1-dayMaleFruP1Consensus_H3K4me3	"1 if H3K4me3 detected in gene in 1 day old male fru-P1 expressing neurons (using consensus peak method) in Palmateer, et al. 2021"
flag_palmateer2021_1-dayMaleFruP1Consensus_H3K27me3	"1 if H3K27me3 detected in gene in 1 day old male fru-P1 expressing neurons (using consensus peak method) in Palmateer, et al. 2021"
flag_palmateer2021_10-12dayFemaleFruP1Consensus_H3K4me3	"1 if H3K4me3 detected in gene in 10-12 day old female fru-P1 expressing neurons (using consensus peak method) in Palmateer, et al. 2021"
flag_palmateer2021_10-12dayFemaleFruP1Consensus_H3K27me3	"1 if H3K27me3 detected in gene in 10-12 day old female fru-P1 expressing neurons (using consensus peak method) in Palmateer, et al. 2021"
flag_palmateer2021_1-dayFemaleElavConsensus_H3K4me3	"1 if H3K4me3 detected in gene in 1 day old female elav-expressing neurons (using consensus peak method) in Palmateer, et al. 2021"
flag_palmateer2021_1-dayFemaleElavConsensus_H3K27me3	"1 if H3K27me3 detected in gene in 1 day old female elav-expressing neurons (using consensus peak method) in Palmateer, et al. 2021"
flag_palmateer2021_1-dayFemaleFruP1Consensus_H3K4me3	"1 if H3K4me3 detected in gene in 1 day old female fru-P1 expressing neurons (using consensus peak method) in Palmateer, et al. 2021"
flag_palmateer2021_1-dayFemaleFruP1Consensus_H3K27me3	"1 if H3K27me3 detected in gene in 1 day old female fru-P1 expressing neurons (using consensus peak method) in Palmateer, et al. 2021"
flag_palmateer2021_10-12dayMaleFruP1Pool_H3K4me3	"1 if H3K4me3 detected in gene in 10-12 day old male fru-P1 expressing neurons (using pool peak method) in Palmateer, et al. 2021"
flag_palmateer2021_10-12dayMaleFruP1Pool_H3K27me3	"1 if H3K27me3 detected in gene in 10-12 day old male fru-P1 expressing neurons (using pool peak method) in Palmateer, et al. 2021"
flag_palmateer2021_1-dayMaleElavPool_H3K4me3	"1 if H3K4me3 detected in gene in 1 day old male elav-expressing neurons (using pool peak method) in Palmateer, et al. 2021"
flag_palmateer2021_1-dayMaleElavPool_H3K27me3	"1 if H3K27me3 detected in gene in 1 day old male elav-expressing neurons (using pool peak method) in Palmateer, et al. 2021"
flag_palmateer2021_1-dayMaleFruP1Pool_H3K4me3	"1 if H3K4me3 detected in gene in 1 day old male fru-P1 expressing neurons (using pool peak method) in Palmateer, et al. 2021"
flag_palmateer2021_1-dayMaleFruP1Pool_H3K27me3	"1 if H3K27me3 detected in gene in 1 day old male fru-P1 expressing neurons (using pool peak method) in Palmateer, et al. 2021"
flag_palmateer2021_10-12dayFemaleFruP1Pool_H3K4me3	"1 if H3K4me3 detected in gene in 10-12 day old female fru-P1 expressing neurons (using pool peak method) in Palmateer, et al. 2021"
flag_palmateer2021_10-12dayFemaleFruP1Pool_H3K27me3	"1 if H3K27me3 detected in gene in 10-12 day old female fru-P1 expressing neurons (using pool peak method) in Palmateer, et al. 2021"
flag_palmateer2021_1-dayFemaleElavPool_H3K4me3	"1 if H3K4me3 detected in gene in 1 day old female elav-expressing neurons (using pool peak method) in Palmateer, et al. 2021"
flag_palmateer2021_1-dayFemaleElavPool_H3K27me3	"1 if H3K27me3 detected in gene in 1 day old female elav-expressing neurons (using pool peak method) in Palmateer, et al. 2021"
flag_palmateer2021_1-dayFemaleFruP1Pool_H3K4me3	"1 if H3K4me3 detected in gene in 1 day old female fru-P1 expressing neurons (using pool peak method) in Palmateer, et al. 2021"
flag_palmateer2021_1-dayFemaleFruP1Pool_H3K27me3	"1 if H3K27me3 detected in gene in 1 day old female fru-P1 expressing neurons (using pool peak method) in Palmateer, et al. 2021"
flag_dmel617_miRNA_gene_id	1 in gene is annotated as a miRNA gene in D. melanogaster r6.17 reference
flag_dmel617_gene_id	1 if gene is in D. melanogaster r6.17 reference
flag_dalton2013_fruM_male_regulation	"1 if gene upregulated or downregulated in males with overexpression of FRU-MA, FRU-MB, or FRU-MC isoforms in Dalton, et al. 2013"
flag_dalton2013_fruM_female_regulation	"1 if gene upregulated or downregulated in females with ectopic expression of FRU-MA, FRU-MB, or FRU-MC isoforms in Dalton, et al. 2013"
flag_arbeitman2016_dsx_regulated	"1 if gene determined to be regulated by dsx in Arbeitman, et al. 2016"
flag_courtship_genes	"1 if D. melanogaster gene related to ""courtship"" in GO term"
flag_flight_behavior_genes	"1 if D. melanogaster gene related to ""flight behavior"" in GO term"
flag_flight_all_genes	"1 if D. melanogaster gene related to ""flight"" in GO term"
flag_volt_gtd_k_chnnl_cmplx_genes	"1 if D. melanogaster gene related to ""voltage-gated potassium channel complex"" in GO term"
flag_volt_gtd_k_chnnl_all_genes	"1 if D. melanogaster gene related to ""voltage-gated potassium channel"" in GO term"
flag_K27_methyl_all_genes	"1 if D. melanogaster gene related to ""H3-K27"" and ""methyl"" in GO term"
flag_K4_methyl_all_genes	"1 if D. melanogaster gene related to ""H3-K4"" and ""methyl"" in GO term"
flag_heterochromatin_all_genes	"1 if D. melanogaster gene related to ""heterochromatin"" or ""negative regulation of euchromatin"" in GO term and exluding terms with ""negative regulation of heterochromatin"""
flag_euchromatin_all_genes	"1 if D. melanogaster gene related to ""euchromatin"" or ""negative regulation of heterochromatin"" in GO term and exluding terms with ""negative regulation of euchromatin"""
flag_silencing_genes	"1 if D. melanogaster gene related to ""silencing"" in GO term and excluding terms with ""negative regulation of chromatin silencing"", ""negative regulation of posttranscriptional gene silencing"", ""negative regulation of gene silencing"", ""negative regulation of methylation-dependent chromatin silencing"", and ""negative regulation of production of miRNAs involved in gene silencing"""
flag_dosage_compensation_genes	"1 if D. melanogaster gene related to ""dosage compensation"" in GO term"
flag_any_k4_mel	"1 if H3K4me3 detected in gene in any sex (gene_k4 != ""none"") in D. melanogaster"
flag_any_k4_sim	"1 if H3K4me3 detected in gene in any sex (gene_k4 != ""none"") in D. simulans"
flag_any_k4_both_species	1 if flag_any_k4_mel==1 AND flag_any_k4_sim==1
flag_any_k4_either_species	1 if flag_any_k4_mel==1 OR flag_any_k4_sim==1
flag_any_k4_mel_only	1 if flag_any_k4_mel==1 AND flag_any_k4_sim==0
flag_any_k4_sim_only	1 if flag_any_k4_mel==0 AND flag_any_k4_sim==1
flag_has_male_k4_mel	"1 if H3K4me3 detected in gene in males (gene_k4 != ""none"" or ""fem"") in D. melanogaster"
flag_has_male_k4_sim	"1 if H3K4me3 detected in gene in males (gene_k4 != ""none"" or ""fem"") in D. simulans"
flag_has_male_k4_both_species	1 if flag_has_male_k4_mel==1 and flag_has_male_k4_sim==1
flag_has_male_k4_mel_only	1 if flag_has_male_k4_mel==1 AND flag_has_male_k4_sim==0
flag_has_male_k4_sim_only	1 if flag_has_male_k4_mel==0 AND flag_any_has_male_sim==1
flag_has_female_k4_mel	"1 if H3K4me3 detected in gene in females (gene_k4 != ""none"" or ""male"") in D. melanogaster"
flag_has_female_k4_sim	"1 if H3K4me3 detected in gene in females (gene_k4 != ""none"" or ""male"") in D. simulans"
flag_has_female_k4_both_species	1 if flag_has_female_k4_mel==1 AND flag_has_female_k4_sim==1
flag_has_female_k4_mel_only	1 if flag_has_female_k4_mel==1 AND flag_has_female_k4_sim==0
flag_has_female_k4_sim_only	1 if flag_has_female_k4_mel==0 AND flag_any_has_female_sim==1
flag_male_limited_k4_mel	"1 if H3K4me3 detected in gene only in males (gene_k4 == ""male"") in D. melanogaster"
flag_male_limited_k4_sim	"1 if H3K4me3 detected in gene only in males (gene_k4 == ""male"") in D. simulans"
flag_male_limited_k4_both_species	1 if flag_male_limited_k4_mel==1 and flag_male_limited_k4_sim==1
flag_male_limited_k4_mel_only	1 if flag_male_limited_k4_mel==1 AND flag_male_limited_k4_sim==0
flag_male_limited_k4_sim_only	1 if flag_male_limited_k4_mel==0 AND flag_male_limited_k4_sim==1
flag_female_limited_k4_mel	"1 if H3K4me3 detected in gene only in females (gene_k4 == ""fem"") in D. melanogaster"
flag_female_limited_k4_sim	"1 if H3K4me3 detected in gene only in females (gene_k4 == ""fem"") in D. simulans"
flag_female_limited_k4_both_species	1 if flag_female_limited_k4_mel==1 and flag_female_limited_k4_sim==1
flag_female_limited_k4_mel_only	1 if flag_female_limited_k4_mel==1 AND flag_female_limited_k4_sim==0
flag_female_limited_k4_sim_only	1 if flag_female_limited_k4_mel==0 AND flag_female_limited_k4_sim==1
flag_sex_limited_k4_mel	"1 if gene_k4==""fem"" OR ""male"""
flag_sex_limited_k4_sim	"1 if sim_gene_k4==""fem"" OR ""male"""
flag_sex_limited_k4_both_species	1 if flag_sex_limited_k4_mel==1 AND flag_sex_limited_k4_sim==1
flag_sex_limited_k4_mel_only	1 if flag_sex_limited_k4_mel==1 AND flag_sex_limited_k4_sim==0
flag_sex_limited_k4_sim_only	1 if flag_sex_limited_k4_mel==0 AND flag_sex_limited_k4_sim==1
flag_conserved_sex_limited_k4	1 if flag_female_limited_k4_both_species==1 OR flag_male_limited_k4_both_species==1
flag_any_k27_mel	"1 if H3K27me2me3 detected in gene in any sex (gene_k27 != ""none"") in D. melanogaster"
flag_any_k27_sim	"1 if H3K27me2me3 detected in gene in any sex (gene_k27 != ""none"") in D. simulans"
flag_any_k27_both_species	1 if flag_any_k27_mel==1 AND flag_any_k27_sim==1
flag_any_k27_mel_only	1 if flag_any_k27_mel==1 AND flag_any_k27_sim==0
flag_any_k27_sim_only	1 if flag_any_k27_mel==0 AND flag_any_k27_sim==1
flag_has_male_k27_mel	"1 if H3K27me2me3 detected in gene in males (gene_k27 != ""none"" or ""fem"") in D. melanogaster"
flag_has_male_k27_sim	"1 if H3K27me2me3 detected in gene in males (gene_k27 != ""none"" or ""fem"") in D. simulans"
flag_has_male_k27_both_species	1 if flag_has_male_k27_mel==1 and flag_has_male_k27_sim==1
flag_has_male_k27_mel_only	1 if flag_has_male_k27_mel==1 and flag_has_male_k27_sim==0
flag_has_male_k27_sim_only	1 if flag_has_male_k27_mel==0 and flag_has_male_k27_sim==1
flag_has_female_k27_mel	"1 if H3K27me2me3 detected in gene in females (gene_k27 != ""none"" or ""male"") in D. melanogaster"
flag_has_female_k27_sim	"1 if H3K27me2me3 detected in gene in females (gene_k27 != ""none"" or ""male"") in D. simulans"
flag_has_female_k27_both_species	1 if flag_has_female_k27_mel==1 and flag_has_female_k27_sim==1
flag_has_female_k27_mel_only	1 if flag_has_female_k27_mel==1 and flag_has_female_k27_sim==0
flag_has_female_k27_sim_only	1 if flag_has_female_k27_mel==0 and flag_has_female_k27_sim==1
flag_male_limited_k27_mel	"1 if H3K27me2me3 detected in gene only in males (gene_k27 == ""male"") in D. melanogaster"
flag_male_limited_k27_sim	"1 if H3K27me2me3 detected in gene only in males (gene_k27 == ""male"") in D. simulans"
flag_male_limited_k27_both_species	1 if flag_male_limited_k27_mel==1 and flag_male_limited_k27_sim==1
flag_male_limited_k27_mel_only	1 if flag_male_limited_k27_mel==1 and flag_male_limited_k27_sim==0
flag_male_limited_k27_sim_only	1 if flag_male_limited_k27_mel==0 and flag_male_limited_k27_sim==1
flag_female_limited_k27_mel	"1 if H3K27me2me3 detected in gene only in females (gene_k27 == ""fem"") in D. melanogaster"
flag_female_limited_k27_sim	"1 if H3K27me2me3 detected in gene only in females (gene_k27 == ""fem"") in D. simulans"
flag_female_limited_k27_both_species	1 if flag_female_limited_k27_mel==1 and flag_female_limited_k27_sim==1
flag_female_limited_k27_mel_only	1 if flag_female_limited_k27_mel==1 and flag_female_limited_k27_sim==0
flag_female_limited_k27_sim_only	1 if flag_female_limited_k27_mel==0 and flag_female_limited_k27_sim==1
flag_sex_limited_k27_mel	"1 if gene_k27==""fem"" OR ""male"""
flag_sex_limited_k27_sim	"1 if sim_gene_k27==""fem"" OR ""male"""
flag_sex_limited_k27_both_species	1 if flag_sex_limited_k27_mel==1 AND flag_sex_limited_k27_sim==1
flag_sex_limited_k27_mel_only	1 if flag_sex_limited_k27_mel==1 AND flag_sex_limited_k27_sim==0
flag_sex_limited_k27_sim_only	1 if flag_sex_limited_k27_mel==0 AND flag_sex_limited_k27_sim==1
flag_conserved_sex_limited_k27	1 if flag_female_limited_k27_both_species==1 OR flag_male_limited_k27_both_species==1
flag_expressed_mel	"1 if gene is detected RNA-seq expression (APN>0) in at least one sex (gene_rna != ""none"") in D. melanogaster"
flag_expressed_sim	"1 if gene is detected RNA-seq expression (APN>0) in at least one sex (sim_gene_rna != ""none"") in D. simulans"
flag_expressed_M_mel	"1 if gene is detected RNA-seq expression (APN>0) in males (gene_rna != ""none"" or ""fem"") in D. melanogaster"
flag_expressed_M_sim	"1 if gene is detected RNA-seq expression (APN>0) in males (gene_rna != ""none"" or ""fem"") in D. simulans"
flag_expressed_F_mel	"1 if gene is detected RNA-seq expression (APN>0) in females (gene_rna != ""none"" or ""male"") in D. melanogaster"
flag_expressed_F_sim	"1 if gene is detected RNA-seq expression (APN>0) in females (gene_rna != ""none"" or ""male"") in D. simulans"
flag_sex_limited_mel	"1 if gene is sex-limited, detected (APN>0) in only one sex (gene_rna = ""fem"" or ""male"") in D. melanogaster"
flag_sex_limited_sim	"1 if gene is sex-limited, detected (APN>0) in only one sex (gene_rna = ""fem"" or ""male"") in D. simulans"
flag_male_limited_mel	"1 if gene is male-limited, detected (APN>0) in only males (gene_rna = ""male"") in D. melanogaster"
flag_male_limited_sim	"1 if gene is male-limited, detected (APN>0) in only males (gene_rna = ""male"") in D. simulans"
flag_female_limited_mel	"1 if gene is female-limited, detected (APN>0) in only females (gene_rna = ""fem"") in D. melanogaster"
flag_female_limited_sim	"1 if gene is female-limited, detected (APN>0) in only females (gene_rna = ""fem"") in D. simulans"
flag_low_express_mel	1 if gene is lowly expressed (APN<5) across all exonic features in D. melanogaster
flag_low_express_sim	1 if gene is lowly expressed (APN<5) across all exonic features in D. simulans
flag_sex_biased_mel	"1 if gene is detected in both sexes with statistical evidence of differential expression (gene_trend_ttest = male, female, or male_and_female) in D. melanogaster"
flag_sex_biased_sim	"1 if gene is detected in both sexes with statistical evidence of differential expression (gene_trend_ttest = male, female, or male_and_female) in D. simulans"
flag_U_mel	1 if gene is detected in both sexes with no statistical evidence of differential expression in D. melanogaster
flag_U_sim	1 if gene is detected in both sexes with no statistical evidence of differential expression in D. simulans
flag_M_mel	1 if gene is detected in both sexes with statistical significance with a trend towards male in D. melanogaster
flag_M_sim	1 if gene is detected in both sexes with statistical significance with a trend towards male in D. simulans
flag_M_mel_only	1 if flag_M_mel==1 AND flag_M_sim==0
flag_M_sim_only	1 if flag_M_mel==0 AND flag_M_sim==1
flag_M_mel_U_sim	1 if flag_M_mel==1 AND flag_U_sim==1
flag_M_sim_U_mel	1 if flag_M_sim==1 AND flag_U_mel==1
flag_MP_mel	1 if gene is detected in both sexes with flag_M_mel==1 and at least 2-fold change towards male in D. melanogaster
flag_MP_sim	1 if gene is detected in both sexes with flag_M_sim==1 and at least 2-fold change towards male in D. simulans
flag_F_mel	1 if gene is detected in both sexes with statistical significance with a trend towards female in D. melanogaster
flag_F_sim	1 if gene is detected in both sexes with statistical significance with a trend towards female in D. simulans
flag_F_mel_only	1 if flag_F_mel==1 AND flag_F_sim==0
flag_F_sim_only	1 if flag_F_mel==0 AND flag_F_sim==1
flag_F_mel_U_sim	1 if flag_F_mel==1 AND flag_U_sim==1
flag_F_sim_U_mel	1 if flag_F_sim==1 AND flag_U_mel==1
flag_M_mel_F_sim	1 if flag_M_mel==1 AND flag_F_sim==1
flag_M_sim_F_mel	1 if flag_M_sim==1 AND flag_F_mel==1
flag_FP_mel	1 if gene is detected in both sexes with flag_F_mel==1 and at least 2-fold change towards female in D. melanogaster
flag_FP_sim	1 if gene is detected in both sexes with flag_F_sim==1 and at least 2-fold change towards female in D. simulans
flag_MF_mel	1 if gene is detected in both sexes with at least one exonic feature statistically significant in males and at least one in females in D. melanogaster
flag_MF_sim	1 if gene is detected in both sexes with at least one exonic feature statistically significant in males and at least one in females in D. simulans
flag_MF_mel_only	1 if flag_MF_mel==1 AND flag_MF_sim==0
flag_MF_sim_only	1 if flag_MF_mel==0 AND flag_MF_sim==1
flag_MF_mel_U_sim	1 if flag_MF_mel==1 AND flag_U_sim==1
flag_MF_sim_U_mel	1 if flag_MF_sim==1 AND flag_U_mel==1
flag_MFP_mel	1 if gene is detected in both sexes with flag_MF_mel + at least 2-fold change in each of the sex-biased exonic regions in D. melanogaster
flag_MFP_sim	1 if gene is detected in both sexes with flag_MF_sim + at least 2-fold change in each of the sex-biased exonic regions in D. simulans
flag_sex_bias_both_species	1 if flag_sex_biased_mel==1 and flag_sex_biased_sim==1
flag_conserved_sex_bias	1 if gene has conserved sex bias direction where (flag_M_mel==1 and flag_M_sim==1) OR (flag_F_mel==1 and flag_F==1) OR (flag_MF_mel==1 and flag_MF_sim==1)
flag_conserved_male_bias	1 if gene has conserved male bias where flag_M_mel==1 and flag_M_sim==1
flag_conserved_female_bias	1 if gene has conserved female bias where flag_F_mel==1 and flag_F_sim==1
flag_conserved_male_and_female	1 if gene has conserved male and female bias where flag_MF_mel==1 and flag_MF_sim==1
flag_conserved_unbiased	1 if gene has conserved unbiased expression where flag_U_mel==1 and flag_U_sim==1
flag_sex_bias_mel_only	1 if gene is sex-biased in D. melanogaster (flag_M_mel==1 or flag_F_mel==1 or flag_MF_mel==1) and unbiased in D. simulans (flag_U_sim==1)
flag_sex_bias_sim_only	1 if gene is sex-biased in D. simulans (flag_M_sim==1 or flag_F_sim==1 or flag_MF_sim==1) and unbiased in D. melanogaster (flag_U_mel==1)
flag_switch_M_U	1 if flag_M_mel_U_sim==1 OR flag_M_sim_U_mel==1
flag_switch_F_U	1 if flag_F_mel_U_sim==1 OR flag_F_sim_U_mel==1
flag_switch_M_F	1 if flag_M_mel_F_sim==1 OR flag_M_sim_F_mel==1
flag_diverged_sex_bias	1 if _(flag_sex_biased_mel + _flag_sex_biased_sim)>0 AND flag_conserved_sex_bias==0
num_mel_gene_ID_2_sim_geneID	Number of unique mel_geneID associated with the given sim_geneID
num_sim_gene_ID_2_mel_geneID	Number of unique sim_geneID associated with the given mel_geneID
flag_one2one_ortholog	1 if mel_geneID is the only ortholog to the given sim_geneID and vice versa (paralogs are excluded)